##########
# ########
 O########
  ########
# #   ####
# # # ####
# # # #   
#   #   ##
# #### ###
##########